Salvē (Hello!) = "A friend is a second self"—Cicero

This is Alexander = Hic est Alexandēr
This is Rosa = Haec est Rōsa

Hello (sing./pl.) = Salvē. / Salvēte
Goodbye (sing./pl.) = Valē. / Valēte

What is your name? = Quid tibi nōmen est?
My name is Rosa = Nōmen mihi Rōsa est

How are you? = Ut valēs?  Ut valētis?
I am well = Valeō
I am excellent = Optime valeō
I am good = Bene valeō
I am fine = Rēctē valeō
I am well enough = Satis bene valeō
I am not bad = Nōn male valeō
I am bad = Male valeō
I am very bad = Pessimē valeō

I am Alexander = Ego sum Alexander
Who? (m/f) = Quis? / Quae?

Stand up = Surge
Walk = Ambula
Stop = Consiste
Sit down = Consīde
Run = Curre
Go out = Exī
Jump = Salī

Where are you?
Where am I? = Ubi es / sum?
Here / There = Hīc / Illīc
Is it Trevor? = Estne Trevor?
Yes / No = Ita / Nōn

Either Trevor or Montaigne? = Utrum Trevor an Updike?
Neither Trevor nor Montaigne = Neque Trevor neque Montaigne
Come / Go / Return = Vēnī / Ī / Revertēre
Come / Go / Return (plūrālis) = Vēnite / Īte / Revertīminī
Go to the table = Ī ad mēnsam
Return to your chair = Revertēre ad sellam tuam
