Partēs corporis (Body parts) = "If his legs fail him, he fights on his knees." —Seneca, De Providentia, c. 2.

Extend your fingers = Extendē digitōs
Extend your arm = Extendē bracchium
Extend your head = Extendē caput
Contract your fingers = Contrahē digitōs
Contract your arm = Contrahē bracchium
Contract your head = Contrahē caput
Lift your leg = Tolle crus
Lift your left hand shoulder = Tolle manum sinistram
Lift your shoulder = Tolle humerum
Lower your leg = Dēmitte crus
Lower your right hand = Dēmitte manum dextram
Lower your shoulder = Dēmitte humerum
Touch your hand = Tangē manum
Touch your nose = Tangē nāsum
Touch your teeth = Tangē dentēs
Touch your head = Tangē caput

Head = Caput
Eye = Oculus
Ear = Auris
Mouth = Ōs
Shoulder = Humerus
Chest = Pectus
Leg = Crus
Knee = Genu
Hair = Capillī
Nose = Nāsus
Finger = Digitus
Hand = Manus
Arm = Bracchium
Elbow = Cubitus
Foot = Pēs

Open your mouth! = Aperī ōs!
Speak! = Loquere!
Shout! = Clāmā!
Speak! in English/French/Greek = Loquere Anglicē! / Gallicē! / Graecē!
Sing! = Canē!
Whistle! = Sībilā!
Bark! = Lātrā!
