Nationēs (Countries) = “It is good to obey the laws of one’s country.” —Gyaecis

United States of America = Cīvitātēs Foederātae Americae
New York = Novum Eborācum
Salt Lake City = Urbs Lacūs Salsī Magnī
Canada = Canada
Mexico = Mexicum
Venezuela = Venezuela
Colombia = Columbia
Ecuador = Aequātōria
Peru = Peruvia
Brazil = Brasilia
Bolivia = Bolivia
Chile = Chilia
Argentina = Argentina
Buenos Aires = Bonus Aer
Ireland = Hibernia
Great Britain = Magna Britanniā
London = Londinium
Netherlands = Nederlandia
Belgium = Belgium
Germany = Germānia
Berlin = Berolīnum
Poland = Polonia
Warsaw = Varsāvia
Denmark = Danavia
Switzerland = Helvētia
France = Gallia
Paris = Lūtētia
Romania = Rōmānia
Bucharest = Bucarestiī
Ukraine = Ucrainia
Italy = Italia
Rome = Rōma
Greece = Graecia
Athens = Athēnae
Spain = Hispānia
Madrid = Matrītum
Portugal = Lusitānia
Algeria = Algerium
Libya = Lībyā
Egypt = Aegyptus
Kenya = Kenia
Arabia = Arabia
Persia (Iran) = Persia
India = India
China = Sinae
Japan = Iaponia
Korea = Corea
Australia = Austrālia
Europe = Eurōpa
Asia = Asia
Oceania = Oceania
Homeland / Fatherland = Patria
New World = Mundus Novus
The Nile = Nīlus
The Ganges = Gangēs
Pacific Ocean = Oceanus Pacificus
Atlantic Ocean = Oceanus Atlanticus
Indian Ocean = Oceanus Indicūs
